111111111111111111111111111111
100000000100010000000000000001
100000000100010000000000000001
1000000001000C0000000000E00001
100000C00100000000001000000001
1P0000100100000000001000000001
111111111111111111111111111111
