111111111111111111111111111111
100000000000010000000000000001
100000000000010000000000000001
1000000000000C0000000000E00001
100000C00000000000001000000001
1P0000100000000000001000000001

