111111111111111111111111111111
100000000000010000000000000001
100000000000010000000000000001
1000000000001C0000000000000001
100000C00000000000001000000011
1P0000100000000000001000000EC1
111111111111111111111111111111
